親切な: しんせつな: Kind
便利な: べんりな: Useful
知る: しる: To know
速い: はやい: Fast
長い: ながい: Long (length)
別に: べつに: Besides
頭がいい: あたまがいい: Smart
背が高い: せがたかい: Tall
背が低い: せがひくい: Short
眼鏡: めがね: Glasses

口: くち: Mouth
耳: みみ: Ear
髪: かみ: Hair
目: め: Eye
歯: は: Tooth
鼻: はな: Nose
頭: あたま: Head
顔: かお: Face
手: て: Hand
肩: かた: Shoulder
背中: せなか: Back
足: あし: Foot

料理する: りょうりする: To cook
電話する: でんわする: To call
掃除する: そうじする: To clean
洗濯する: せんたくする: To do laundry
運転する: うんてんする: To drive
遅くなる: おそくなる: To be late
作る: つくる: To make
持っていく: もっていく: To take
雨が降る: あめがふる: To rain
今朝: けさ: This morning
黒板: こくばん: Blackboard
空気: くうき: Air
会社員: かいしゃいん: Office worker





